##############################
##############################
##                          ##
##                          ##
##                          ##
##                          ##
##                          ##
##                          ##
##                          ##
##            B        s    ##
##                          ##
##                          ##
##                          ##
##                          ##
##                          ##
##                          ##
##                          ##
##                          ##
##############################
##############################
