##############################
##########   #     #   #     #
#        #   ##    #   ##    #
#        #    #    #    ##   #
####    ###   #    #######   #
#         #   #              #
#         #   ####         # #
s         #      #      #### #
#         #      #     #     #
#                      #######
#     ##                     #
##### ##                     #
#   #                        #
#   #                  # #####
#   #    #######  # ####     #
#   #    #             #     #
#        #             #     #
#        #             #     e 
#        #             #     #
##############################
