##############################
##############################
##                          ##
##                          ##
##                          ##
##                          ##
##                          ##
##                          ##
##                          ##
##            B             ##
##                          ##
##                          ##
##                          ##
##                          ##
##                          ##
##                          ##
##                          ##
##                          ##
##############################
##############################
