########s#####################
#   #            #     ###   #
#   #            #   m ### m #
#   #######     ####    ##   #
#   #  #        ####     #   #
#   m     m ##   m ##        #
##      #    #   #      ##   #
#########        ######      #
#       #######    #####  m  #
#   # m            #    #    #
#   ################ m       #
#   #              #    ######
#       #######    #    ######
#########                    #
e    #      #   m  #         #
#  m ##    ##      #####  m  #
#   ###     ###   ######     #
#    #            ######   ###
##      #######     ####    ##
##############################
