##############################
##############################
##                          ##
##                          ##
##                          ##
##                          ##
##                          ##
##                          ##
##                          ##
##                     s    ##
##                          ##
##                          ##
##                          ##
##                          ##
##                          ##
##                          ##
##                          ##
##                          ##
##############################
##############################
